111111
1P00E1
100001
1E00C1
111111