111111
1P00P1
100001
1E00C1
111111