11111111111111111111111111111111111111111
1PEC0000000000000000000000000000000000001
11111111111111111111111111111111111111111