11111111
100000P1
1000001
1E0000C1
11111111