111111
1P0001
100000
1E00C1
111111