111111111
1P0000001
1000000C1
111111111
1000000E1
111111111