111111
1P0001
100001
1000C1
111111