110111
1P0001
100001
1E00C1
111111