111111111
1P0000001
111000001
1000E1111
10F0000C1
111111111