11111111111111111
100000000E1C00001
10000000001000001
11001111111000001
10000000000000001
10000000000000001
10000000001000001
11001111111100011
100001C0001000001
10000100001000001
10000110011000001
10000000001000001
1C000000001000001
11111111111110011
10000100000100001
10P00000000000001
10000000100000001
11111111111111111