111111111111111111111
111111111111111111111
110011100111P00000011
110011100111111110011
110011100111111110C11
110000000111111110011
111111100111000000011
111111100111001111111
111111100111C01111111
111111100111001111111
111111100111000000E11
111111111111111111111
111111111111111111111
