1111111111111111111111111111111111111
1111111111111111111111111111111111111
1111111111111111111111111111111111111
1000010101010101010101111111111111111
1111111111111111111111111111111111111
1000000000000CCCCCCCCC111111111111111
1PE1111111111111111111111111111111111
1111111111111111111111111111111111111
1111111111111111111111111111111111111
1111111111111111111111111111111111111
1111111111111111111111111111111111111
1000010101010101010101111111111111111
1111111111111111111111111111111111111
1111111111111111111111111111111111111
1111111111111111111111111111111111111
1111111111111111111111111111111111111
