111111
100001
1P00C1
111F11
1000E1
111111